###################################
#.#.#.##c########.###.###.###.##.##
S.................................#
##.########################.##.##c#
##c#..............c.........##.##.#
##.########################.##.##.E
##...............c..........##.####
##############################.####
#c.................c...........####
###################################